1111111111111
10C10000E00C1
100001000C001
100C011000001
1111111111111
1101101000111
1101101111011
1110P01000011
1111101011111
1111101100011
1111111111111
1111111111111